00 00 00 00 00 00 00 00 00 00 00 00 00 00 00 00 00 00 00 00
00 00 03 00 00 00 00 01 00 00 00 07 07 07 07 00 00 00 01 00
00 00 00 02 00 00 00 00 00 00 00 07 07 07 09 07 00 00 00 00
00 00 00 00 00 00 00 00 00 00 07 10 07 07 07 00 00 00 00 00
00 00 01 00 00 04 00 00 00 00 07 07 00 00 00 00 00 00 00 00
00 00 00 00 00 00 00 00 00 00 00 00 00 00 00 16 00 00 00 00
00 00 00 00 01 00 00 00 00 00 00 00 00 00 00 00 00 00 00 00
00 01 00 00 00 00 00 00 00 00 00 00 00 11 11 11 11 11 11 00
00 00 00 00 00 00 00 00 00 00 00 00 00 11 11 11 11 11 11 00
00 00 14 00 00 00 00 00 00 00 00 00 00 00 11 11 11 11 11 00
00 00 00 00 00 00 01 00 00 00 00 00 00 00 00 00 00 00 11 00
00 00 00 00 00 00 00 00 00 00 00 00 00 00 00 00 00 00 00 00