00 00 00 00 12 07 07 13 17 00 00 00 00 00 00 00 00 00 00 00 00 00 00 00 00 00 00 00 00 00 00 00 00 28 23 23 23 27 00 03 00 02 00 00 00 00 00 01 00 04
00 00 00 00 12 07 07 07 11 00 00 00 00 00 00 00 00 00 00 00 00 00 00 00 00 00 00 00 00 00 00 00 00 34 26 23 23 27 00 00 00 00 00 00 00 00 00 00 00 00
00 00 00 00 12 07 07 08 19 00 00 00 00 00 00 00 00 00 00 00 00 00 00 00 00 00 00 00 02 00 00 00 00 00 28 23 23 27 00 00 00 00 00 00 00 00 00 00 00 00
00 00 00 16 15 07 07 11 00 00 00 00 00 00 00 00 00 00 00 00 00 00 00 00 00 00 00 00 00 00 00 00 00 00 28 23 23 29 33 00 00 00 00 00 05 00 00 00 00 00
00 03 00 12 21 07 20 11 00 00 00 00 00 00 02 00 03 00 00 00 00 00 03 00 00 00 00 00 00 00 00 00 00 00 28 23 23 23 27 00 00 06 00 00 00 00 00 00 00 03
00 00 00 12 07 07 07 13 17 00 00 00 00 00 00 00 00 00 00 00 00 00 00 00 00 00 00 00 00 00 00 00 00 00 34 26 23 23 29 33 00 00 00 00 00 00 00 00 00 00
00 00 16 15 07 07 07 07 11 00 00 00 00 00 00 00 00 00 00 00 00 00 00 00 00 00 00 00 00 00 00 00 00 00 00 28 23 23 23 29 33 00 00 00 00 03 00 00 00 00
00 01 12 07 20 07 07 07 11 00 00 00 00 00 00 00 00 00 00 00 00 00 00 00 03 00 00 00 00 00 00 00 00 00 00 34 26 23 23 23 29 30 30 30 30 30 30 30 30 30
04 00 12 07 07 20 07 08 19 00 00 00 00 00 00 00 00 00 00 00 00 00 00 00 00 00 00 00 00 00 00 00 00 00 00 00 28 23 23 23 23 23 23 23 23 23 23 23 23 23
02 16 15 07 07 07 08 19 00 00 00 00 03 00 00 00 00 00 00 00 00 00 16 14 14 14 14 14 17 00 00 00 00 00 00 00 34 26 23 23 23 23 23 23 23 23 23 23 23 23
00 12 07 07 07 07 11 00 00 00 00 00 00 00 00 00 00 00 00 00 16 14 15 07 20 07 07 07 11 00 00 00 00 00 00 00 00 28 23 23 23 23 23 23 23 23 23 23 23 23
01 12 07 07 07 07 11 00 00 00 00 00 00 03 00 00 00 00 06 02 12 07 07 07 07 20 07 08 19 00 00 00 00 00 00 00 00 28 23 23 23 23 24 25 25 25 26 23 23 23
00 18 10 07 07 21 11 01 00 00 00 00 00 00 00 00 00 00 16 14 15 07 07 07 07 08 09 19 00 00 00 01 00 00 03 00 03 28 23 23 23 23 27 00 00 00 34 25 26 23
00 00 12 07 07 07 13 17 00 00 00 00 00 00 00 00 00 00 12 07 07 07 20 07 07 11 00 00 00 00 00 00 00 00 00 00 00 28 23 23 23 24 35 04 00 00 00 00 28 23
00 00 12 07 07 07 07 11 00 00 00 00 00 00 00 02 00 00 18 09 09 09 10 07 08 19 00 00 00 00 00 00 00 03 00 01 00 28 23 23 23 27 00 00 00 00 05 00 28 23
00 00 12 07 07 07 07 11 00 00 00 00 00 00 00 03 00 16 14 14 17 00 18 09 19 00 00 00 00 00 00 03 00 00 00 00 00 28 23 23 23 27 00 00 00 00 00 32 31 23
00 00 12 07 07 07 07 11 00 00 00 00 00 00 00 16 14 15 07 07 11 00 00 00 01 00 00 00 00 00 00 00 00 00 00 00 00 28 23 23 23 29 33 00 00 00 32 31 23 23
00 00 12 07 07 07 07 11 00 00 00 00 00 00 16 15 07 07 07 07 11 00 00 00 00 00 00 00 00 00 00 00 00 00 00 00 00 34 26 23 23 23 29 30 30 30 31 23 23 23
00 00 12 21 07 07 07 13 17 00 00 00 00 01 12 07 20 07 07 08 19 00 00 16 14 14 17 00 00 00 00 00 00 00 00 00 00 00 34 26 23 23 23 23 23 23 23 23 23 23
05 00 18 10 07 07 07 07 11 00 00 00 03 00 12 07 07 07 07 13 17 05 00 12 07 21 11 00 00 00 00 00 02 00 00 00 00 00 00 34 26 23 23 23 23 23 23 23 23 23
00 00 00 12 07 07 07 07 11 00 00 00 00 00 12 07 07 07 07 07 11 00 00 12 07 08 19 00 00 00 00 00 00 00 00 00 00 00 00 00 34 26 23 23 23 23 23 23 23 23
00 00 00 18 10 07 07 07 11 00 00 01 00 00 18 09 09 09 09 09 19 00 00 12 07 11 00 00 00 00 00 00 00 05 00 00 00 00 00 00 00 34 26 23 23 23 23 23 23 23
00 00 00 00 12 07 07 07 13 17 00 00 00 00 00 00 00 00 00 00 00 00 00 18 09 19 00 00 00 04 00 00 00 00 00 00 00 00 00 00 04 00 34 26 23 23 23 23 23 23
00 00 00 00 18 10 07 07 07 13 17 00 00 00 00 00 00 00 00 00 00 00 00 00 00 00 00 00 00 00 00 00 00 00 00 00 00 00 00 00 00 00 00 34 26 23 23 23 23 23
00 00 00 00 00 12 07 07 07 07 13 17 00 00 00 00 00 00 00 00 00 00 00 00 00 00 02 00 00 00 00 00 00 00 04 00 00 00 00 00 00 00 00 00 28 23 23 23 23 23
00 00 00 00 00 18 10 07 07 07 07 11 00 00 00 00 00 00 00 00 00 00 00 00 00 00 00 00 00 00 00 00 00 00 00 00 00 00 00 00 00 00 00 00 34 26 23 23 23 23
30 33 00 00 00 00 12 07 07 07 07 13 14 17 00 01 00 00 00 00 00 00 00 00 00 00 00 00 00 02 00 00 00 00 00 00 00 03 00 00 00 00 00 00 00 34 26 23 23 23
23 27 01 00 00 00 18 10 07 07 07 07 07 11 00 00 00 00 00 00 00 00 00 00 00 00 00 02 00 00 00 00 00 00 00 00 00 00 00 00 00 00 00 00 00 00 28 23 23 23
23 27 00 00 00 00 00 12 07 07 07 07 07 11 04 00 00 00 00 00 00 00 00 00 00 00 00 00 00 00 00 00 00 01 00 00 00 00 00 00 00 00 00 00 00 00 28 23 23 23
23 29 33 00 00 00 00 18 10 07 20 21 20 13 17 00 00 00 00 00 00 00 00 00 00 00 00 00 00 00 00 00 00 00 00 00 00 00 04 00 00 00 00 00 00 00 28 23 23 23
23 23 27 00 00 00 00 00 12 07 07 07 07 07 11 00 00 00 00 00 00 00 00 00 00 00 00 00 00 00 00 00 00 00 00 00 00 00 00 00 00 00 00 00 00 00 28 23 23 23
23 23 27 00 00 00 00 00 12 07 07 07 07 07 13 14 14 17 00 00 00 00 00 03 00 00 00 00 00 00 00 00 00 00 00 00 00 00 00 00 00 01 00 01 00 00 28 23 23 23
23 23 27 00 00 00 00 02 12 07 07 07 07 07 07 07 07 11 00 00 00 02 00 00 00 00 01 00 00 00 00 00 00 00 32 30 30 33 00 01 00 00 00 00 00 00 28 23 23 23
23 23 27 00 00 00 00 02 18 10 07 07 07 07 07 07 07 13 14 17 00 00 00 00 00 00 00 00 00 00 00 00 00 00 28 23 23 29 30 30 33 00 00 05 00 00 34 26 23 23
23 23 29 33 00 00 00 00 16 15 07 07 07 07 07 07 07 07 07 13 14 17 00 00 00 00 00 00 00 00 00 04 00 00 34 26 23 23 23 23 29 33 00 00 00 00 00 28 23 23
23 23 23 27 00 00 00 00 12 07 07 07 07 07 07 07 07 07 07 07 07 11 00 00 00 00 00 05 00 00 00 00 00 00 32 31 23 23 23 23 23 27 00 00 00 00 00 28 23 23
23 23 23 27 00 00 00 00 12 07 07 07 07 07 07 07 07 07 07 07 07 11 00 00 00 00 00 00 06 00 00 00 00 00 28 23 23 23 23 23 24 35 00 00 00 00 32 31 23 23
23 23 23 27 00 00 00 00 18 09 10 21 07 07 07 07 07 07 07 07 07 11 00 00 00 00 00 00 00 00 00 00 00 00 28 23 23 23 23 23 27 00 00 00 00 00 28 23 23 23
23 23 23 29 30 33 00 00 00 00 18 10 07 07 07 07 07 07 07 07 07 11 00 00 00 00 00 00 00 00 00 00 00 00 34 26 23 23 24 25 35 00 00 00 00 00 28 23 23 23
23 23 23 23 23 27 00 00 00 00 00 18 10 07 07 07 07 07 07 07 07 11 00 00 00 00 00 00 00 00 00 00 00 00 00 34 25 25 35 00 00 00 00 00 00 00 28 23 23 23
23 23 23 23 23 29 33 00 00 00 01 00 18 09 09 09 10 07 07 07 08 19 00 00 00 00 00 00 00 00 00 00 00 00 00 00 00 00 00 00 00 00 00 00 00 32 31 23 23 23
23 23 23 23 23 23 29 33 00 00 01 00 00 00 00 00 18 09 09 09 19 00 00 00 00 00 00 00 00 00 00 00 00 00 00 00 00 00 00 00 00 00 00 00 00 28 23 23 23 23
23 23 23 23 23 23 23 29 30 30 30 33 00 00 00 00 00 00 00 00 00 00 00 00 00 00 04 00 01 00 00 00 00 00 00 00 00 00 00 00 00 00 00 00 32 31 23 23 23 23
23 23 23 23 23 23 23 23 23 23 23 29 30 30 30 30 30 30 30 30 33 00 00 00 00 00 00 00 00 03 00 02 00 00 00 00 00 00 00 00 00 00 32 30 31 23 23 23 23 23
23 23 23 23 23 23 23 23 23 23 23 23 23 23 23 23 23 23 23 23 29 30 30 30 30 30 30 33 00 00 00 00 32 30 30 30 30 30 30 30 30 30 31 23 23 23 23 23 23 23
23 23 23 23 23 23 23 23 23 23 23 23 23 23 23 23 23 23 23 23 23 23 23 23 23 23 23 29 30 30 30 30 31 23 23 23 23 23 23 23 23 23 23 23 23 23 23 23 23 23
23 23 23 23 23 23 23 23 23 23 23 23 23 23 23 23 23 23 23 23 23 23 23 23 23 23 23 23 23 23 23 23 23 23 23 23 23 23 23 23 23 23 23 23 23 23 23 23 23 23
23 23 23 23 23 23 23 23 23 23 23 23 23 23 23 23 23 23 23 23 23 23 23 23 23 23 23 23 23 23 23 23 23 23 23 23 23 23 23 23 23 23 23 23 23 23 23 23 23 23
23 23 23 23 23 23 23 23 23 23 23 23 23 23 23 23 23 23 23 23 23 23 23 23 23 23 23 23 23 23 23 23 23 23 23 23 23 23 23 23 23 23 23 23 23 23 23 23 23 23
23 23 23 23 23 23 23 23 23 23 23 23 23 23 23 23 23 23 23 23 23 23 23 23 23 23 23 23 23 23 23 23 23 23 23 23 23 23 23 23 23 23 23 23 23 23 23 23 23 23